  R         975                       700
   NO ./texture/colorstone.XPM
 SO                     ./texture/bluestone.XPM
WE ./texture/greystone.XPM
EA             ./texture/mossy.XPM
             S ./texture/barrel.XPM
F    50  , 200,    80
C  250, 150, 50

    1111111111111111111111111111111111       111111
    1000000000111200000000000011111111       111111
    10002000000000000000S00000000000011111111100001
    10000000001121100000200000000000000000000000001
    10000000000000000000000111111111111111111111001
    10000000111100000000000111111111111111111111001
    10000000000000000000200000000000000000000000001
    10000000000000000000000000111111111110011111111
    10000000011111111100001111111111111110011111111
    100001000111111111110001111111111111100101111
    10000011111111111111100000000000000000011111111
    10002000111111111111110111111111111110011111111
    10000000111111111111100111111111111110011111111
    10000000000000000000000000000000000000000000001
    11000000000000010000000000000100000000011111001
    01000110000000110000000000111100000000011111001
    11001111000000000000020000000000000000011111001
    10000000000000000000000000000000000000000000001
    11111111001111111111000000001111111111111111111
    11111111001111111111000000001000000000000000001
    11111111001111111111100000000000000000000000001
    11111111001111111111111001111000000000000000000
    11111111001111111111110000011000000000000000001
    11111111001111111100000000111111000000000000001
    10000000000000000000000000001111110000000000001
    10000000000011110000000000001111110000000000001
    1000010000001  10000000000001111111100000000001
    1111111111111  11111111111111111111111111111111
