  R         975                       700
   NO ./texture/colorstone.XPM
 SO                     ./texture/bluestone.XPM
WE ./texture/greystone.XPM
EA             ./texture/mossy.XPM
             S ./texture/barrel.XPM
F    50  , 200,    80
C  250, 150, 50

111111111111111111111
100000000000002100001
1000W0000000000100001
100000000000000000001
100002000020000200001
100000000000000000001
111111111111111111111




